{
    "type": "map",
    "name": "test",
    "palette": {
        "#": "physical/wall",
        ".": "physical/floor",
        "0": "physical/door"
    },
    "floor": [
        "............",
        "............",
        "............",
        "............",
        "............",
        "............",
        "............",
        "............",
        "............",
        "............",
        "............",
        "............"
    ],
    "entity": [
        "############",
        "#          #",
        "#  #########",
        "#          #",
        "#          #",
        "##########0#",
        "#          #",
        "#    ##    #",
        "#    ##    #",
        "#    ##    #",
        "#          #",
        "############"
    ]
}